20 The labyrinth size is 20x20
1 The initial position is (1,0)
X              XXXXX
I XXXXXXXXXXXXXXXXXX
X       XXXXXXXXXXXX
XXXXXXX      XXXXXXX
        XXXXXXXXXXXX
XXXXXXX      XXXXXXX
XXXXXXX XXXXXXXXXXXX
XXXXXXX    XXXXXXXXX
XXX     XXXX      XX
XXXXXXX XXXX XXXXXXX
XXXXX   XXXX      XX
XXXXXX XXXXX XXXXXXX
XXXX   XXXXX     XXX
XXXX XXXXXXX XXXXXXX
XXXX          XXXXXX
XXXXXXXXXX    XXXXXX
XXX        XXXXXXXXX
XXXXXXXXX       XXXX
XXXXXXXXXX         S
XXXXXXXXXXXXXXXXXXXX
