20 The labyrinth size is 20x20
1 The initial position is (1,0)
XXXXXXXXXXXXXXXXXXXX
I    XXXXX     XXXXX
XXXX       XXXXXXXXX
XXXXXXX XXXX       X
X       XXXX XXX XXX
XX  XXX      XXX XXX
XX XXXX XXXXXXXX XXX
XX XXXX    XXXXXXXXX
XX      XXXX      XX
XXXXXXX XXXX  XXXXXX
XXXX             XXX
XXXX XXXXX XXXXX XXX
XXXX XXX           X
XXXX XXXX XXXXXXXXXX
XXXX          XXXXXX
XXXXXXXXXX    XXXXXX
XXX        XXXXXXXXX
XXXXXXXXX   X      S
XXXXXXXXXX       XXX
XXXXXXXXXXXXXXXXXXXX
